//MAP CONVERTED BY dmm2tgm.py THIS HEADER COMMENT PREVENTS RECONVERSION, DO NOT REMOVE
"cK" = (
/obj/structure/fluff/statue/pillar,
/turf/open/floor/churchrough,
/area/rogue)
"df" = (
/obj/structure/fermentation_keg/water,
/turf/open/floor/cobble/alt,
/area/rogue)
"dw" = (
/obj/effect/dungeon_directional_helper/south,
/turf/open/floor/naturalstone,
/area/rogue)
"fI" = (
/obj/structure/closet/crate/crafted_closet,
/obj/item/clothing/shirt/undershirt/fancy,
/obj/effect/spawner/map_spawner/loot/weapon,
/obj/item/clothing/head/fancyhat,
/turf/open/floor/churchrough,
/area/rogue)
"fT" = (
/obj/structure/flora/grass/bush,
/turf/open/floor/dirt,
/area/rogue)
"fY" = (
/turf/closed/wall/window,
/area/rogue)
"gw" = (
/mob/living/carbon/human/species/skeleton/npc/warrior,
/turf/open/floor/blocks,
/area/rogue)
"gx" = (
/obj/item/natural/rock,
/obj/item/natural/bundle/stoneblock,
/turf/open/floor/churchrough,
/area/rogue)
"hB" = (
/turf/closed/mineral/bedrock,
/area/rogue)
"ji" = (
/obj/structure/flora/grass/bush,
/obj/structure/flora/grass/bush/wall,
/turf/open/floor/dirt,
/area/rogue)
"jr" = (
/turf/open/floor/cobble/alt,
/area/rogue)
"jI" = (
/turf/open/floor/blocks,
/area/rogue)
"kr" = (
/mob/living/carbon/human/species/skeleton/npc/warrior,
/turf/open/floor/churchrough,
/area/rogue)
"lw" = (
/obj/structure/chair/bench/throne,
/mob/living/carbon/human/species/skeleton/npc/warrior/skilled,
/obj/effect/mapping_helpers/floor_clothing_equipper,
/obj/item/weapon/axe/boneaxe,
/obj/item/clothing/head/helmet/heavy/rust,
/obj/item/clothing/armor/plate/rust,
/turf/open/floor/churchrough,
/area/rogue)
"mo" = (
/obj/machinery/light/fueled/wallfire/candle,
/turf/open/floor/blocks,
/area/rogue)
"om" = (
/obj/structure/rack/shelf/biggest,
/obj/item/reagent_containers/glass/bottle/vial/strongpoison,
/obj/item/book/random_book,
/turf/open/floor/cobble/alt,
/area/rogue)
"pd" = (
/obj/item/candle/skull,
/turf/open/floor/churchrough,
/area/rogue)
"pJ" = (
/turf/closed/wall/mineral/decostone/moss,
/area/rogue)
"ro" = (
/obj/structure/door/iron,
/turf/open/floor/blocks,
/area/rogue)
"sz" = (
/obj/item/natural/rock,
/turf/open/floor/dirt,
/area/rogue)
"sT" = (
/obj/structure/gate,
/turf/open/floor/dirt,
/area/rogue)
"tf" = (
/turf/closed/wall/mineral/decostone/moss/cand,
/area/rogue)
"tt" = (
/mob/living/carbon/human/species/skeleton/npc,
/turf/open/floor/cobble,
/area/rogue)
"tC" = (
/turf/open/floor/church,
/area/rogue)
"un" = (
/obj/structure/door/red,
/obj/effect/mapping_helpers/access/locker,
/turf/open/floor/churchrough,
/area/rogue)
"vX" = (
/obj/structure/inert_bonepile,
/turf/open/floor/blocks,
/area/rogue)
"wG" = (
/obj/item/natural/bundle/stoneblock,
/turf/open/floor/churchrough,
/area/rogue)
"xh" = (
/turf/closed/wall/mineral/decostone,
/area/rogue)
"xk" = (
/obj/structure/door/weak,
/turf/open/floor/cobblerock,
/area/rogue)
"xn" = (
/obj/machinery/light/fueled/wallfire/candle,
/turf/open/floor/churchrough,
/area/rogue)
"yu" = (
/obj/effect/dungeon_directional_helper/north,
/turf/open/floor/naturalstone,
/area/rogue)
"yD" = (
/obj/machinery/light/fueled/hearth,
/turf/open/floor/cobble/alt,
/area/rogue)
"zB" = (
/obj/item/chair/fancy,
/turf/open/floor/cobble/alt,
/area/rogue)
"Ay" = (
/obj/structure/bed/shit,
/obj/effect/spawner/map_spawner/loot/weapon,
/turf/open/floor/cobble,
/area/rogue)
"AS" = (
/obj/structure/bed/shit,
/turf/open/floor/cobble,
/area/rogue)
"Ch" = (
/obj/structure/bed/shit,
/obj/effect/spawner/map_spawner/loot/armor,
/turf/open/floor/cobble,
/area/rogue)
"Cz" = (
/turf/open/floor/naturalstone,
/area/rogue)
"De" = (
/obj/item/bedsheet/pelt,
/obj/structure/bed/wool,
/obj/machinery/light/fueled/wallfire/candle,
/turf/open/floor/churchrough,
/area/rogue)
"DM" = (
/turf/open/transparent/openspace,
/area/rogue)
"FU" = (
/obj/structure/chair/wood,
/mob/living/carbon/human/species/rousman/npc,
/turf/open/floor/churchrough,
/area/rogue)
"Gz" = (
/obj/structure/fluff/statue/knight,
/turf/open/floor/churchrough,
/area/rogue)
"Hu" = (
/turf/open/floor/cobble,
/area/rogue)
"HL" = (
/obj/structure/closet/crate/chest/neu,
/obj/item/reagent_containers/glass/bowl,
/obj/item/kitchen/spoon,
/obj/item/reagent_containers/glass/cup/wooden,
/obj/item/reagent_containers/glass/cup/wooden,
/turf/open/floor/cobble/alt,
/area/rogue)
"HY" = (
/obj/structure/table/wood/plain,
/obj/structure/fluff/millstone,
/turf/open/floor/cobble/alt,
/area/rogue)
"IB" = (
/obj/effect/dungeon_directional_helper/east,
/turf/open/floor/naturalstone,
/area/rogue)
"JD" = (
/obj/structure/inert_bonepile,
/turf/open/floor/cobble/alt,
/area/rogue)
"JY" = (
/obj/structure/inert_bonepile,
/turf/open/floor/churchrough,
/area/rogue)
"Kj" = (
/obj/structure/table/wood/fancy/black,
/obj/item/reagent_containers/glass/cup/fancy_clay,
/obj/item/reagent_containers/glass/bottle/redwine,
/turf/open/floor/churchrough,
/area/rogue)
"Kr" = (
/obj/machinery/light/fueled/wallfire/candle,
/turf/closed/wall/mineral/decostone/moss,
/area/rogue)
"MF" = (
/obj/effect/dungeon_directional_helper/west,
/turf/open/floor/naturalstone,
/area/rogue)
"MO" = (
/obj/effect/mapping_helpers/secret_door_creator{
	redstone_id = MLK1
	},
/turf/closed/wall/mineral/decostone/moss,
/area/rogue)
"NH" = (
/turf/open/floor/dirt,
/area/rogue)
"Oj" = (
/obj/structure/closet/crate/chest/neu_iron,
/obj/item/carvedgem/coral/fish,
/obj/item/carvedgem/amber/figurine,
/obj/item/carvedgem/amber/figurine,
/obj/effect/mapping_helpers/access/locker,
/turf/open/floor/churchrough,
/area/rogue)
"Pu" = (
/turf/open/floor/churchrough,
/area/rogue)
"PC" = (
/obj/item/clothing/cloak/apron/brown,
/obj/item/chair/stool/bar,
/turf/open/floor/cobblerock,
/area/rogue)
"Qv" = (
/obj/structure/table/stone_small,
/obj/item/carvedgem/turq/fancyvase,
/turf/open/floor/churchrough,
/area/rogue)
"Rc" = (
/turf/open/floor/cobblerock,
/area/rogue)
"RN" = (
/obj/structure/door/weak,
/obj/effect/mapping_helpers/structure/breaker,
/turf/open/floor/cobble,
/area/rogue)
"Um" = (
/obj/structure/fluff/walldeco/stone,
/obj/structure/lever/hidden{
	redstone_id = MLK1;
	pixel_x = null
	},
/turf/closed/wall/mineral/decostone/moss,
/area/rogue)
"Vw" = (
/obj/effect/decal/remains/wolf,
/turf/open/floor/dirt,
/area/rogue)
"VQ" = (
/obj/structure/table/wood,
/obj/item/paper/scroll,
/obj/item/natural/feather,
/turf/open/floor/cobble/alt,
/area/rogue)

(1,1,1) = {"
hB
hB
hB
hB
hB
hB
hB
hB
Cz
MF
Cz
hB
hB
hB
hB
hB
hB
hB
hB
hB
"}
(2,1,1) = {"
hB
NH
NH
NH
NH
NH
NH
NH
Cz
Cz
Cz
NH
NH
NH
ji
fT
NH
NH
NH
hB
"}
(3,1,1) = {"
hB
NH
NH
NH
NH
NH
fT
NH
Cz
Cz
Cz
pJ
pJ
pJ
pJ
pJ
NH
NH
NH
hB
"}
(4,1,1) = {"
hB
fT
fT
NH
NH
pJ
pJ
fY
pJ
pJ
NH
pJ
De
Pu
fI
pJ
NH
NH
NH
hB
"}
(5,1,1) = {"
hB
fT
fT
NH
NH
pJ
AS
Hu
Ay
pJ
NH
pJ
Pu
FU
Kj
pJ
NH
NH
NH
hB
"}
(6,1,1) = {"
hB
NH
NH
NH
NH
pJ
Ch
tt
AS
pJ
NH
pJ
Oj
Pu
Pu
pJ
NH
NH
NH
hB
"}
(7,1,1) = {"
hB
NH
NH
pJ
pJ
pJ
pJ
RN
pJ
pJ
pJ
pJ
tf
Kr
un
pJ
pJ
NH
NH
hB
"}
(8,1,1) = {"
hB
NH
NH
pJ
gw
jI
jI
jI
jI
xh
xn
cK
Pu
Gz
Pu
cK
pJ
pJ
NH
hB
"}
(9,1,1) = {"
Cz
Cz
Cz
sT
jI
Rc
Rc
vX
Rc
xh
kr
Pu
kr
tC
tC
Pu
Qv
pJ
Cz
Cz
"}
(10,1,1) = {"
yu
Cz
Cz
NH
jI
jI
jI
jI
jI
ro
Pu
Pu
Pu
Pu
Pu
Pu
lw
pJ
Cz
dw
"}
(11,1,1) = {"
Cz
Cz
Cz
NH
jr
jI
gw
jI
jI
xh
JY
tC
tC
Pu
Pu
Pu
wG
pJ
Cz
Cz
"}
(12,1,1) = {"
hB
NH
NH
pJ
mo
jI
jI
Rc
jr
tf
Pu
cK
Pu
gx
pd
cK
pJ
pJ
NH
hB
"}
(13,1,1) = {"
hB
NH
NH
pJ
pJ
pJ
xh
xk
xh
pJ
xh
xh
Um
MO
pJ
pJ
pJ
NH
NH
hB
"}
(14,1,1) = {"
hB
NH
NH
NH
fT
pJ
df
jr
HL
pJ
VQ
om
jr
jr
pJ
NH
NH
NH
NH
hB
"}
(15,1,1) = {"
hB
NH
NH
NH
NH
pJ
Rc
PC
HY
pJ
zB
JD
jr
jr
pJ
NH
NH
NH
NH
hB
"}
(16,1,1) = {"
hB
NH
NH
NH
NH
pJ
Rc
yD
jr
pJ
pJ
pJ
pJ
pJ
pJ
NH
NH
NH
NH
hB
"}
(17,1,1) = {"
hB
NH
NH
fT
NH
pJ
sz
pJ
pJ
pJ
NH
NH
NH
NH
NH
NH
NH
fT
NH
hB
"}
(18,1,1) = {"
hB
NH
NH
NH
NH
NH
NH
NH
Cz
Cz
Cz
NH
NH
NH
NH
NH
NH
fT
NH
hB
"}
(19,1,1) = {"
hB
NH
NH
NH
NH
NH
NH
NH
Cz
Cz
Cz
NH
NH
NH
NH
NH
NH
fT
Vw
hB
"}
(20,1,1) = {"
hB
hB
hB
hB
hB
hB
hB
hB
Cz
IB
Cz
hB
hB
hB
hB
hB
hB
hB
hB
hB
"}

(1,1,2) = {"
hB
hB
hB
hB
hB
hB
hB
hB
DM
DM
DM
hB
hB
hB
hB
hB
hB
hB
hB
hB
"}
(2,1,2) = {"
hB
DM
DM
DM
DM
DM
DM
DM
DM
DM
DM
DM
DM
DM
DM
DM
DM
DM
DM
hB
"}
(3,1,2) = {"
hB
DM
DM
DM
DM
DM
DM
DM
DM
DM
DM
jI
jI
jI
jI
jI
DM
DM
DM
hB
"}
(4,1,2) = {"
hB
DM
DM
DM
DM
jI
jI
jI
jI
jI
DM
jI
jI
DM
jI
jI
DM
DM
DM
hB
"}
(5,1,2) = {"
hB
DM
DM
DM
DM
jI
DM
DM
jI
jI
DM
jI
jI
jI
jI
jI
DM
DM
DM
hB
"}
(6,1,2) = {"
hB
DM
DM
DM
DM
jI
DM
jI
jI
jI
DM
jI
jI
jI
jI
jI
DM
DM
DM
hB
"}
(7,1,2) = {"
hB
DM
DM
jI
jI
jI
jI
jI
jI
jI
jI
jI
jI
jI
jI
jI
jI
DM
DM
hB
"}
(8,1,2) = {"
hB
DM
DM
jI
DM
DM
jI
jI
jI
jI
jI
jI
jI
jI
DM
jI
jI
jI
DM
hB
"}
(9,1,2) = {"
DM
DM
DM
jI
jI
jI
jI
jI
jI
jI
jI
DM
jI
jI
DM
jI
jI
jI
DM
DM
"}
(10,1,2) = {"
DM
DM
DM
jI
jI
DM
DM
jI
DM
jI
jI
jI
jI
jI
DM
jI
jI
jI
DM
DM
"}
(11,1,2) = {"
DM
DM
DM
jI
jI
jI
jI
jI
jI
jI
DM
jI
jI
jI
jI
DM
DM
jI
DM
DM
"}
(12,1,2) = {"
hB
DM
DM
jI
jI
jI
DM
DM
DM
jI
jI
DM
DM
jI
jI
jI
jI
jI
DM
hB
"}
(13,1,2) = {"
hB
DM
DM
jI
jI
jI
jI
jI
jI
jI
jI
jI
jI
jI
jI
jI
jI
DM
DM
hB
"}
(14,1,2) = {"
hB
DM
DM
DM
DM
jI
jI
jI
jI
jI
jI
jI
jI
jI
jI
DM
DM
DM
DM
hB
"}
(15,1,2) = {"
hB
DM
DM
DM
DM
jI
DM
DM
jI
jI
jI
jI
jI
jI
jI
DM
DM
DM
DM
hB
"}
(16,1,2) = {"
hB
DM
DM
DM
DM
jI
jI
DM
jI
jI
jI
jI
jI
jI
jI
DM
DM
DM
DM
hB
"}
(17,1,2) = {"
hB
DM
DM
DM
DM
jI
jI
jI
jI
jI
DM
DM
DM
DM
DM
DM
DM
DM
DM
hB
"}
(18,1,2) = {"
hB
DM
DM
DM
DM
DM
DM
DM
DM
DM
DM
DM
DM
DM
DM
DM
DM
DM
DM
hB
"}
(19,1,2) = {"
hB
DM
DM
DM
DM
DM
DM
DM
DM
DM
DM
DM
DM
DM
DM
DM
DM
DM
DM
hB
"}
(20,1,2) = {"
hB
hB
hB
hB
hB
hB
hB
hB
DM
DM
DM
hB
hB
hB
hB
hB
hB
hB
hB
hB
"}
