//MAP CONVERTED BY dmm2tgm.py THIS HEADER COMMENT PREVENTS RECONVERSION, DO NOT REMOVE
"af" = (
/turf/open/floor/naturalstone,
/area/rogue/under/tomb/cave/lava)
"ag" = (
/obj/structure/table/stone_small,
/obj/effect/spawner/map_spawner/loot/common,
/obj/effect/spawner/map_spawner/loot/common,
/turf/open/floor/cobblerock,
/area/rogue/under/tomb/cave/lava)
"ah" = (
/turf/closed/mineral/bedrock,
/area/rogue/under/tomb/cave/lava)
"ai" = (
/turf/closed/wall/mineral/decostone/moss,
/area/rogue/under/tomb/cave/lava)
"aj" = (
/obj/machinery/light/fueled/hearth,
/turf/open/floor/cobblerock,
/area/rogue/under/tomb/cave/lava)
"aw" = (
/obj/structure/fluff/statue/knight,
/turf/open/floor/cobblerock,
/area/rogue/under/tomb/cave/lava)
"aG" = (
/turf/open/floor/cobblerock,
/area/rogue/under/tomb/cave/lava)
"aI" = (
/obj/item/natural/bundle/stoneblock,
/obj/effect/spawner/map_spawner/loot/coin/med,
/turf/open/floor/cobblerock,
/area/rogue/under/tomb/cave/lava)
"aS" = (
/obj/effect/dungeon_directional_helper/south,
/turf/open/floor/naturalstone,
/area/rogue/under/tomb/cave/lava)
"aT" = (
/obj/structure/fluff/statue/pillar,
/turf/open/floor/cobblerock,
/area/rogue/under/tomb/cave/lava)
"cS" = (
/obj/machinery/light/fueled/wallfire/candle,
/turf/closed/wall/mineral/decostone/moss,
/area/rogue/under/tomb/cave/lava)
"dG" = (
/obj/structure/fluff/walldeco/chains,
/mob/living/carbon/human/species/skeleton/npc,
/turf/open/floor/cobblerock,
/area/rogue/under/tomb/cave/lava)
"en" = (
/obj/item/candle/skull,
/turf/open/floor/cobblerock,
/area/rogue/under/tomb/cave/lava)
"eX" = (
/obj/item/bin/water,
/turf/open/floor/cobblerock,
/area/rogue/under/tomb/cave/lava)
"gp" = (
/obj/effect/dungeon_directional_helper/east,
/turf/open/floor/naturalstone,
/area/rogue/under/tomb/cave/lava)
"hA" = (
/turf/closed/mineral/bedrock,
/area/rogue/under/tomb/indoors)
"ig" = (
/obj/structure/rack/shelf/biggest,
/obj/item/reagent_containers/glass/bottle/vial/strongpoison,
/obj/item/book/random_book,
/turf/open/floor/cobblerock,
/area/rogue/under/tomb/cave/lava)
"iG" = (
/obj/item/natural/rock,
/turf/open/floor/cobblerock,
/area/rogue/under/tomb/cave/lava)
"iQ" = (
/obj/structure/gate,
/turf/open/floor/cobblerock,
/area/rogue/under/tomb/cave/lava)
"jH" = (
/obj/structure/fermentation_keg/water,
/turf/open/floor/cobblerock,
/area/rogue/under/tomb/cave/lava)
"kF" = (
/obj/structure/fluff/big_chain,
/turf/open/floor/metal/barograte,
/area/rogue/under/tomb/cave/lava)
"lG" = (
/obj/structure/door/iron,
/turf/open/floor/cobblerock,
/area/rogue/under/tomb/cave/lava)
"lO" = (
/obj/item/natural/bundle/stoneblock,
/obj/item/natural/stone,
/obj/item/natural/stone,
/turf/open/floor/cobblerock,
/area/rogue/under/tomb/cave/lava)
"nA" = (
/obj/structure/bars/pipe/left,
/turf/open/floor/metal/barograte,
/area/rogue/under/tomb/indoors)
"nC" = (
/obj/structure/ladder,
/turf/open/floor/metal/barograte,
/area/rogue/under/tomb/cave/lava)
"nT" = (
/obj/structure/bed/shit,
/turf/open/floor/cobblerock,
/area/rogue/under/tomb/cave/lava)
"oB" = (
/obj/item/gun/ballistic/revolver/grenadelauncher/crossbow,
/obj/effect/landmark/chest_or_mimic,
/obj/item/dmusicbox,
/turf/open/floor/metal/barograte,
/area/rogue/under/tomb/cave/lava)
"oC" = (
/obj/structure/door/red,
/obj/effect/mapping_helpers/access/locker,
/turf/closed/wall/mineral/decostone/moss,
/area/rogue/under/tomb/cave/lava)
"pO" = (
/obj/structure/closet/crate/chest/neu_iron,
/obj/effect/mapping_helpers/access/locker,
/obj/effect/spawner/map_spawner/loot/rare,
/obj/effect/spawner/map_spawner/loot/rare,
/obj/effect/spawner/map_spawner/loot/magic,
/turf/open/floor/cobblerock,
/area/rogue/under/tomb/cave/lava)
"rg" = (
/turf/open/floor/metal/barograte,
/area/rogue/under/tomb/cave/lava)
"rS" = (
/obj/effect/dungeon_directional_helper/north,
/turf/open/floor/dirt/road,
/area/rogue/under/tomb/cave/lava)
"so" = (
/turf/open/floor/metal{
	dir = 4
	},
/area/rogue/under/tomb/cave/lava)
"th" = (
/obj/structure/chair/wood,
/turf/open/floor/cobblerock,
/area/rogue/under/tomb/cave/lava)
"to" = (
/obj/structure/bed/shit,
/turf/open/floor/metal/barograte,
/area/rogue/under/tomb/indoors)
"tq" = (
/obj/structure/fluff/walldeco/chains,
/obj/structure/bars/pipe,
/turf/open/transparent/openspace,
/area/rogue/under/tomb/cave/lava)
"uy" = (
/obj/structure/fluff/wallclock,
/obj/item/flashlight/flare/torch/lantern/copper,
/obj/structure/closet/crate/chest,
/obj/effect/mapping_helpers/access/locker,
/turf/open/floor/metal/barograte,
/area/rogue/under/tomb/indoors)
"uR" = (
/obj/structure/fluff/walldeco/chains,
/turf/open/floor/metal,
/area/rogue/under/tomb/cave/lava)
"uV" = (
/turf/open/transparent/openspace,
/area/rogue/under/tomb/cave/lava)
"wj" = (
/obj/item/ammo_casing/caseless/bolt{
	pixel_x = -9
	},
/obj/item/ammo_casing/caseless/bolt{
	pixel_y = 11
	},
/obj/item/ammo_casing/caseless/bolt{
	pixel_y = 10;
	pixel_x = -25
	},
/obj/item/ammo_casing/caseless/bolt{
	pixel_y = -16
	},
/obj/item/ammo_casing/caseless/bolt{
	pixel_x = 11
	},
/turf/open/floor/metal/barograte,
/area/rogue/under/tomb/cave/lava)
"wZ" = (
/mob/living/carbon/human/species/skeleton/npc/warrior,
/turf/open/floor/cobblerock,
/area/rogue/under/tomb/cave/lava)
"xx" = (
/obj/structure/bed/shit,
/obj/effect/spawner/map_spawner/loot/weapon,
/obj/effect/spawner/map_spawner/loot/weapon,
/turf/open/floor/cobblerock,
/area/rogue/under/tomb/cave/lava)
"xH" = (
/obj/structure/bed/wool,
/obj/item/bedsheet/pelt,
/turf/open/floor/cobblerock,
/area/rogue/under/tomb/cave/lava)
"xV" = (
/obj/structure/table/wood,
/obj/item/paper/scroll,
/obj/item/natural/feather,
/turf/open/floor/cobblerock,
/area/rogue/under/tomb/cave/lava)
"zm" = (
/obj/structure/table/wood/plain,
/obj/structure/fluff/millstone,
/turf/open/floor/cobblerock,
/area/rogue/under/tomb/cave/lava)
"zY" = (
/turf/closed/wall/mineral/decostone,
/area/rogue/under/tomb/cave/lava)
"Ar" = (
/turf/open/floor/metal,
/area/rogue/under/tomb/cave/lava)
"Av" = (
/obj/structure/fluff/walldeco/chains,
/turf/open/transparent/openspace,
/area/rogue/under/tomb/cave/lava)
"AC" = (
/turf/closed/wall/mineral/pipe,
/area/rogue/under/tomb/indoors)
"DC" = (
/obj/structure/bed/shit,
/obj/effect/spawner/map_spawner/loot/armor,
/obj/effect/spawner/map_spawner/loot/armor,
/turf/open/floor/cobblerock,
/area/rogue/under/tomb/cave/lava)
"DD" = (
/turf/closed/wall/window,
/area/rogue/under/tomb/cave/lava)
"Ea" = (
/obj/structure/lever/hidden,
/turf/closed/wall/mineral/decostone/moss,
/area/rogue/under/tomb/cave/lava)
"Fc" = (
/obj/structure/chair/bench/throne,
/mob/living/carbon/human/species/skeleton/npc/warrior/skilled,
/obj/effect/mapping_helpers/floor_clothing_equipper,
/obj/item/weapon/axe/boneaxe,
/obj/item/clothing/head/helmet/heavy/rust,
/obj/item/clothing/armor/plate/rust,
/turf/open/floor/cobblerock,
/area/rogue/under/tomb/cave/lava)
"FE" = (
/obj/structure/closet/crate/chest/neu,
/obj/item/reagent_containers/glass/bowl,
/obj/item/kitchen/spoon,
/obj/item/dice_cup/wooden,
/obj/item/dice_cup/wooden,
/turf/open/floor/cobblerock,
/area/rogue/under/tomb/cave/lava)
"Gp" = (
/obj/structure/door/weak,
/turf/open/floor/cobblerock,
/area/rogue/under/tomb/cave/lava)
"Ji" = (
/turf/open/floor/dirt/road,
/area/rogue/under/tomb/cave/lava)
"JY" = (
/obj/structure/inert_bonepile,
/turf/open/floor/cobblerock,
/area/rogue/under/tomb/cave/lava)
"OQ" = (
/obj/structure/table/wood/fancy/black,
/obj/item/reagent_containers/glass/bottle/redwine,
/turf/open/floor/cobblerock,
/area/rogue/under/tomb/cave/lava)
"OR" = (
/obj/machinery/light/fueled/wallfire/candle,
/turf/open/floor/cobblerock,
/area/rogue/under/tomb/cave/lava)
"OZ" = (
/obj/structure/floordoor,
/turf/open/floor/metal,
/area/rogue/under/tomb/indoors)
"PH" = (
/obj/structure/closet/crate/crafted_closet,
/obj/effect/spawner/map_spawner/loot/weapon,
/obj/effect/spawner/map_spawner/loot/coin/high,
/turf/open/floor/cobblerock,
/area/rogue/under/tomb/cave/lava)
"PL" = (
/obj/structure/bars/pipe,
/turf/open/transparent/openspace,
/area/rogue/under/tomb/cave/lava)
"Rl" = (
/obj/item/gear{
	pixel_x = -6
	},
/obj/item/gear{
	pixel_y = -4;
	pixel_x = 6
	},
/obj/item/gear{
	pixel_x = 1;
	pixel_y = 5
	},
/turf/open/floor/metal/barograte,
/area/rogue/under/tomb/indoors)
"Rz" = (
/obj/structure/door/weak,
/obj/effect/mapping_helpers/structure/breaker,
/turf/open/floor/cobblerock,
/area/rogue/under/tomb/cave/lava)
"RX" = (
/turf/open/floor/metal/barograte,
/area/rogue/under/tomb/indoors)
"Sk" = (
/turf/closed/wall/mineral/decostone/moss/cand,
/area/rogue/under/tomb/cave/lava)
"Sl" = (
/obj/item/chair/stool/bar,
/turf/open/floor/cobblerock,
/area/rogue/under/tomb/cave/lava)
"Vk" = (
/turf/open/floor/metal{
	dir = 8
	},
/area/rogue/under/tomb/cave/lava)
"WZ" = (
/obj/item/natural/poo/cow,
/turf/open/floor/metal,
/area/rogue/under/tomb/cave/lava)
"Xv" = (
/obj/item/natural/poo,
/turf/open/floor/metal,
/area/rogue/under/tomb/cave/lava)
"YL" = (
/obj/effect/dungeon_directional_helper/west,
/turf/open/floor/naturalstone,
/area/rogue/under/tomb/cave/lava)
"Ze" = (
/obj/effect/mapping_helpers/secret_door_creator,
/turf/closed/wall/mineral/decostone/moss,
/area/rogue/under/tomb/cave/lava)
"Zr" = (
/obj/item/chair/fancy,
/turf/open/floor/cobblerock,
/area/rogue/under/tomb/cave/lava)
"ZG" = (
/obj/item/ammo_holder/quiver/bolts,
/turf/open/floor/metal/barograte,
/area/rogue/under/tomb/cave/lava)

(1,1,1) = {"
ah
ah
ah
ah
ah
ah
ah
ah
af
YL
af
ah
ah
ah
ah
ah
ah
ah
ah
ah
"}
(2,1,1) = {"
ah
aG
aG
aG
aG
aG
aG
aG
aG
aG
aG
aG
aG
aG
aG
aG
aG
aG
aG
ah
"}
(3,1,1) = {"
ah
aG
aG
aG
aG
aG
aG
aG
aG
aG
aG
ai
ai
ai
ai
ai
aG
aG
aG
ah
"}
(4,1,1) = {"
ah
aG
aG
aG
aG
ai
ai
DD
ai
ai
aG
ai
xH
aG
PH
ai
aG
aG
aG
ah
"}
(5,1,1) = {"
ah
aG
aG
aG
aG
ai
nT
aG
xx
ai
aG
ai
aG
th
OQ
ai
aG
aG
aG
ah
"}
(6,1,1) = {"
ah
aG
aG
aG
aG
ai
DC
aG
nT
ai
aG
ai
pO
aG
aG
ai
aG
aG
aG
ah
"}
(7,1,1) = {"
ah
aG
aG
ai
ai
ai
ai
Rz
ai
ai
ai
ai
Sk
cS
oC
ai
ai
aG
aG
ah
"}
(8,1,1) = {"
ah
aG
aG
ai
dG
aG
aG
aG
aG
zY
OR
aT
aG
aw
aG
aT
ai
ai
aG
ah
"}
(9,1,1) = {"
Ji
aG
aG
iQ
aG
aG
aG
JY
aG
zY
aG
aG
wZ
aG
aG
aG
ag
ai
aG
af
"}
(10,1,1) = {"
rS
aG
aG
aG
aG
aG
aG
aG
aG
lG
aG
aG
aG
aG
aG
aG
Fc
ai
aG
aS
"}
(11,1,1) = {"
Ji
aG
aG
aG
aG
aG
aG
aG
aG
zY
JY
aG
aG
aG
aG
aG
aI
ai
aG
af
"}
(12,1,1) = {"
ah
aG
aG
ai
OR
aG
aG
aG
aG
zY
aG
aT
aG
lO
en
aT
ai
ai
aG
ah
"}
(13,1,1) = {"
ah
aG
aG
ai
ai
ai
zY
Gp
ai
Sk
ai
ai
Ea
Ze
ai
ai
ai
aG
aG
ah
"}
(14,1,1) = {"
ah
aG
aG
aG
aG
ai
jH
aG
FE
ai
xV
ig
aG
aG
ai
aG
aG
aG
aG
ah
"}
(15,1,1) = {"
ah
aG
aG
aG
aG
ai
aG
Sl
zm
ai
Zr
JY
aG
eX
ai
aG
aG
aG
aG
ah
"}
(16,1,1) = {"
ah
aG
aG
aG
aG
ai
aG
aj
aG
ai
ai
ai
ai
ai
ai
aG
aG
aG
aG
ah
"}
(17,1,1) = {"
ah
aG
aG
aG
aG
ai
iG
ai
ai
ai
aG
aG
aG
aG
aG
aG
aG
aG
aG
ah
"}
(18,1,1) = {"
ah
aG
aG
aG
aG
aG
aG
aG
aG
aG
aG
aG
aG
aG
aG
aG
aG
aG
aG
ah
"}
(19,1,1) = {"
ah
aG
aG
aG
aG
aG
aG
aG
aG
aG
aG
aG
aG
aG
aG
aG
aG
aG
aG
ah
"}
(20,1,1) = {"
ah
ah
ah
ah
ah
ah
ah
ah
af
gp
af
ah
ah
ah
ah
ah
ah
ah
ah
ah
"}

(1,1,2) = {"
ah
ah
ah
ah
ah
ah
ah
rg
rg
rg
rg
rg
ah
ah
ah
ah
ah
ah
ah
ah
"}
(2,1,2) = {"
ah
uV
uV
uV
uV
uV
uV
Ar
rg
rg
rg
Ar
uV
uV
uV
uV
uV
PL
uV
ah
"}
(3,1,2) = {"
ah
uV
uV
Ar
Ar
uV
uV
Ar
rg
kF
rg
Ar
Ar
Ar
uR
uV
uV
PL
uV
ah
"}
(4,1,2) = {"
ah
uV
Ar
rg
kF
Ar
uV
PL
Ar
Ar
Ar
uV
uV
uV
Ar
uV
uV
PL
uV
ah
"}
(5,1,2) = {"
ah
uV
uV
Ar
Ar
uV
uV
PL
uV
Ar
uV
uV
uV
uV
Ar
uV
uV
PL
uV
ah
"}
(6,1,2) = {"
ah
uV
uV
uV
PL
uV
uV
tq
uV
uV
uV
uV
uV
Ar
kF
Ar
uV
PL
uV
ah
"}
(7,1,2) = {"
ah
so
so
uV
PL
uV
uV
PL
uV
Ar
uV
uV
uV
Ar
rg
Ar
uV
PL
uV
ah
"}
(8,1,2) = {"
rg
rg
kF
so
uV
uV
uV
Ar
Vk
Ar
Ar
uV
uV
Ar
kF
Ar
uV
PL
uV
ah
"}
(9,1,2) = {"
rg
rg
rg
so
uV
uV
Ar
kF
wj
rg
kF
Ar
uV
uV
Ar
uV
uV
Ar
Ar
Ar
"}
(10,1,2) = {"
rg
rg
rg
so
uV
Ar
so
oB
rg
nC
rg
Ar
WZ
uV
Ar
Ar
Ar
kF
rg
rg
"}
(11,1,2) = {"
rg
rg
rg
so
uV
uV
Ar
kF
ZG
rg
kF
Ar
uV
uV
uV
uV
Ar
kF
rg
rg
"}
(12,1,2) = {"
rg
rg
kF
so
uV
uV
uV
Ar
Ar
Ar
Ar
uV
uV
uV
uV
uV
PL
Ar
Ar
Ar
"}
(13,1,2) = {"
ah
so
so
uV
uV
uV
uV
Ar
uV
uV
uV
uV
Ar
Ar
uV
uV
PL
uV
uV
ah
"}
(14,1,2) = {"
ah
uV
Ar
uV
uV
uV
uV
Av
uV
uV
Ar
Ar
rg
rg
Ar
uV
PL
uV
uV
ah
"}
(15,1,2) = {"
ah
uV
Ar
Ar
Ar
uV
uV
Xv
uV
uV
uV
Ar
kF
rg
Ar
uV
PL
uV
uV
ah
"}
(16,1,2) = {"
ah
Ar
rg
rg
rg
Ar
Ar
Ar
Ar
uV
uV
uV
Ar
Ar
AC
AC
AC
AC
AC
hA
"}
(17,1,2) = {"
ah
Ar
rg
kF
rg
Ar
uV
uV
Ar
Ar
Ar
uV
uV
Ar
OZ
RX
RX
RX
RX
hA
"}
(18,1,2) = {"
ah
Ar
rg
rg
rg
Ar
uV
Ar
rg
kF
rg
Ar
uV
Ar
AC
uy
RX
RX
RX
hA
"}
(19,1,2) = {"
ah
uV
Ar
Ar
Ar
uV
uV
Ar
rg
rg
rg
Ar
uV
uV
AC
nA
RX
Rl
to
hA
"}
(20,1,2) = {"
ah
ah
ah
ah
ah
ah
ah
rg
rg
rg
rg
rg
ah
ah
hA
hA
hA
hA
hA
hA
"}
